10
43
.............#############....#####........
..############.....#.....######...#........
..#.............#######...........#........
###.#........#..#.....#..#####..P.#........
#...##########..#O.#..#..#...#....#........
#............#..####..#..#...######........
#...########.#........#..#.................
#...#......#.##########..#.................
#####......#.............#.................
...........###############.................
