18
19
###################
#.................#
#.......O.........#
#.................#
#.................#
#########..########
#.................#
###############..##
#.................#
#.......###########
#####......########
#####......########
#####......########
#.................#
#.................#
#..........P......#
#.................#
###################