14
21
#####################
#....##...##........#
#....##...##........#
#....##...##........#
#.........##........#
#.......O.##........#
#.........##........#
#.....######...P....#
#...................#
#...................#
#...................#
#...................#
#...................#
#####################